0000000000000000000000000000000000000000000000000000000000000000
0000000000000000000000000000000000000000000000000000000000000000
0011111111111111111111111111111111111111111111111111111110000000
0010000000000000000000000000000000000000000000000000000001000000
0010111111111111111111111111111111111111111111111111111101000000
0010100000000000000000000000000000000000000000000000010101000000
0010101000000000000000000000000000000000000000000000010101111100
0010101000111111111111111111111111111111111111111111010101000100
0010101000100000000000000100000000000000000000000001010101000100
0010101000100010000000000100000000000000000000000001010101000100
0010101000100010000000000101111111111111111111111101010101000100
0010101000111111100000000101000000000000000000000101010101000100
0010101000100010100000000101011111111111111111110101010101000100
0010101000103010100000000101010000000000000001010101010101000100
0010101000101010100000000101010000000000000001010101010101000100
0010101000101010100000000101010101000000000101010101010101000100
0010101000101010100000000101010101000000000101010101010101000100
0010101000101010100000000101010101000000000101010101010101000100
0010101000101010100000000101010101000000000101010101010101000100
0010101000101010100000000101010101000000000101010101010101000100
0010101000101010100000000101010101000000000101010101010101000100
0010101000101010100000000101010101000000000101010101010101000100
0010101000101010100000000101010101000000000101010101010101000100
0010101000101010100000000101010101000000000101010101010101000100
0010101000101010100000000101010101000000000101010101010101000100
0010101000101010100000000101010101000000000101010101010101000100
0010101000101010100000000101010101000000000101010101010101000100
0010101000101010100000000101010101000000000101010101010101000100
0010101000101010100000000101010101000000000101010101010101000100
0010101000101010100000000101010101000000000101010101010101000100
0010101000101010100000000101010111111111110101010101010101000100
0010101000101010100000000101010101000000000101010101010101000100
0010101000101010100000000101010101000000000101010101010101000100
0010101000101010100000000101010101000000000101010101010101000100
0010101000101010100000000101010101000000000101010101010101000100
0010101000101010100000000101010101000000000101010101010101000100
0010101000101010100000000101010101000000000101010101010101000100
0010101000101010100000000101010101000000000101010101010101000100
0010101000101010100000000101010101000000000101010101010101000100
0010101000101010100000000101010101111111100101010101010101000100
0010101000101010100000000101010101000000000101010101010101000100
0010101000101010100000000101010101111111111101010101010101000100
0010101111111111111100000101010100000000000001010101010101000100
0010101000101010100100000101010111111111111111010101010101000100
0010101000101010100100000101010000000000000000000101010101000100
0010101000101010100100000101011111111111111111111101010101000100
0010101000101010100100000101000000000000000000000001010101000100
0010101000101010100100000101111111111111111111111111010101000100
0010101000101010100100000100000000000000000000000000010101000100
0010101000101010100100000100000000000000000000000000010101000100
0010101000101010100100000111111111111111111111111111110101000100
0010101000101010100100000000000000000000000000000000010101000100
0010101000101010100100111111111111111111111111000000000101000100
0010101000101010100100100001000000000000000001001111111111000100
0010101000101010100111100001001111111111111111000000000101000100
0010101000101010100000000001001000000000000000000000000101000100
0010101000101010100000000001001001111111111111111111111111000100
0010100000101010111111111111001000000000000000000000000101000100
0010100000101010000000000000001000000000000000000000000101000100
0010111111101011111111111111111111111111111111111111111111000000
0010000000001000000000000000000000000000000000000000000001000000
0011111111111111111111111111111111111111111111111111111111112000
0000000000000000000000000000000000000000000000000000000000000000
0000000000000000000000000000000000000000000000000000000000000000
