111111111
101002001
101011101
101000101
101111101
100010001
111010101
130000101
111111111
