111111111
101000121
101010101
100010001
111111101
100010001
101110111
100003001
111111111
