0000000000000000000000000000000000000000000000000000000000000000
0211111111111111111111111111111111111111111111111111111111000000
0001000000000000000000000000000000000010000000000000000001000000
0001000000000000000000000000000000000010000000000000000001000000
0001000000000000000000000000000000000010000000000000000001000000
0001000111111111111111111111111111111111111111111111100001000000
0001000100000000100000000000000000000010000000000000100001000000
0001000100000000100000000000000000000010000000000000100001000000
0001000100000000100000000000000000000010000000000000100001000000
0001000100011111111111111111111111111111111111111000100001000000
0001000100010000100000000000000000000000000000001000100001000000
0001000100010000100000000000000000000000000000001000100001000000
0001000111111111111111111111111111111111111111111111100001000000
0001000100010000000000000000000000000000000000001000100001000000
0001000100010000000000000000000000000000000000001000100001000000
0001000100010000011111111111111111111111111000001000100001000000
0001000100010000010000000000000000000000001000001000100001000000
0001000100010000010000000000000000000000001000001111111111000000
0001000100010000010000000000000000000000001000001000100001000000
0001000100010000010000000000000000000000001000001000100001000000
0001000100010000010000000000000000000000001000001000100001000000
0001000100010000010001111111111111111110001000001000100001000000
0001000100010000010001000000000010000010001000001000100001000000
0001000100011111111111000000000010000010001000001000100001000000
0001000100010000010001000000000010000010001000001000100001000000
0001000100010000010001000111111111100010001000001000100001000000
0001000100010000010001000100001000100010001000001000100001000000
0001000100010000010001111100001000100010001111111000100001000000
0001000100010000010001000100001000100010001000001000100001000000
0001000100010000010001000100001000100010001000001000100001000000
0001000100010000010001000100001000100010001000001000100001000000
0001000100010000010001000100001000100010001000001000100001000000
0001000100010000010001000111113111100010001000001000100001000000
0001000100010000010001000100001000100010001000001000100001000000
0001000100010000010001000100001000100010001000001000100001000000
0001000100010000010001000100001000100010001000001000100001000000
0001000100010000010001000100001000111111111111111000100001000000
0001000100010000010001000100001000100010001000001000100001000000
0001000100010000010001000100001000100010001000001000100001000000
0001000100010000010001000111111111100010001000001000100001000000
0001000100010000010001000001000000000010001000001000100001000000
0001000100010000010001000001000000000010001000001000100001000000
0001000100010000010001000001000000000010001000001000100001000000
0001111111111111110001000001000000000010001000001000100001000000
0001000100010000010001111111111111111110001000001000100001000000
0001000100010000010000000001000000000000001000001000100001000000
0001000100010000010000000001000000000000001000001000100001000000
0001000100010000010000000001000000000000001000001000100001000000
0001000100010000011111111111111111111111111000001000100001000000
0001000100010000000000000000000000100000000000001000100001000000
0001000100010000000000000000000000100000000000001000100001000000
0001000100010000000000000000000000100000000000001000100001000000
0001000100011111111111111111111111111111111111111000100001000000
0001000100000000000000000000000000100000000000000000100001000000
0001000100000000000000000000000000100000000000000000100001000000
0001000100000000000000000000000000100000000000000000100001000000
0001000111111111111111111111111111111111111111111111100001000000
0001000001000000000000000000000000100000000000000000000001000000
0001000001000000000000000000000000100000000000000000000001000000
0001000001000000000000000000000000100000000000000000000001000000
0001111111111111111111111111111111111111111111111111111111000000
0000000000000000000000000000000000000000000000000000000000000000
0000000000000000000000000000000000000000000000000000000000000000
0000000000000000000000000000000000000000000000000000000000000000
