1111111
1000021
1111101
1000001
1011111
1000031
1111111
