111111111111111111111
101000000000120000001
101010111110101111101
101010100000101000101
101110111011101010101
100010001000101010101
111011101110101010101
101000001000100010101
101111111011111011101
100010001000001010001
111010101111101110101
100010101000100010101
101110101010111010111
101000100010001010001
101011111110101011101
101000001000101000001
101111101011111111101
101000101000001000001
101010101111101011111
100013000000100000001
111111111111111111111
