0000000000000000000000000000000000000000000000000000000000000000
0211111111111111111111111000000000000000000000000000000000000000
0100100000000000000000010000000001111111111111100000000000000000
0100100000000000000000010000000001000000000000100000000000000000
0100100000000000000000011111111111100000000000100000000000000000
0100111111111111110000010000000000000000000000100000000000000000
0100000000000000010000010000000000000000000000100000000000000000
0100000000000000010000010000000000000000000000100000000000000000
0100000000000000010000010000000000000000000000100000000000000000
0100000000000000010000010000000000000000000000100000000000000000
0100000000000000010000000000000000000000000000100000000000000000
0100000000000000010000000000000000000000000000100000000000000000
0111111111110000010000000000000000000000000000100000000000000000
0000000000010000010000000000000000000000000000100000000000000000
0000000000010000010000000000000000000000000000100000000000000000
0000000000010000010000000000000000000000000000100000000000000000
0000000000010000010000000000000000000000000000100000000000000000
0000000000010000010000000000000000000000000000100000000000000000
0000000000010000110000000000000001000000000000100000000000000000
0000000000010000011111111111111111000000000000100000000000000000
0000000000010000000000000000000001000000000000100000000000000000
0000000000010000000000000000000001000000000000100000000000000000
0000000000010000000000000000000001000000000000100000000000000000
0000000000010000000000000000000001000000000000100000000000000000
0000000000010000000000000000000001000000000000100000000000000000
0000001000010000000000000000000001000000000000100000000000000000
0000011111111111111000000000000001000000000000100000000000000000
0000001000000000000000000000000001000000000000100000000000000000
0000001000000000000000000000000001000000000000100000000000000000
0000001000000000000000000000000001000000000000100000000000000000
0000001000000000000000000000000001000000000000100000000000000000
0000001000000000000000000000000001000000000000100000000000000000
0000001000000000000000000000000001000000000000100000000000000000
0000001000000000000000000000000001000000000000100000000000000000
0000001000000000000000000000000001000000000000100000000000000000
0000001000000000000000000000000001000000000000111111111111000000
0000001000000000000000000000000001000000000000100000000010000000
0000001000000000000000000000000001000000000000000000000010000000
0000001000000000000000000000000001000000000000000000000010000000
0000001000000000000000000000000001000000000000000000000010000000
0000001000000000000000000000000001000000000000000000000010000000
0000001000000000000000000000000001000000000000000000000010000000
0000001000000000000000000000000001000000000000000000000010000000
0000001000000000000000000000000001000000000000000000000010000000
0000001000000000000000000000000001000000000000000000000010000000
0000001000000000000000000000000001000000000000000000000010000000
0000001000000000000000000000000001000000000000000000000010000000
0000001000000000000000000000000001000000000000000000000010000000
0000011111000000000000000000000001000000000000000000000010000000
0000000001000000000000000000000001000000000000000000000010000000
0000000001000000000000000000000001000000000000000000000010000000
0000000001000000000000000000000001000000000000000000000010000000
0000000001000000000000000000000001000000000000000000000010000000
0000000001000000000000000000000001000000000000000000000010000000
0000000001000000000000000000000001000000000000000000000010000000
0000000001000000000000000000000001000000000000000000000010000000
0000000001000000000000000000000001000000000000000000000010000000
0000000001000000000000000000000001000000000000000000000000000000
0000000001000000000000000000000001000000000000000000000000000000
0000000001000000000000000000000001000000000000000000000000000000
0000001111111111111111111111100011111111111111111111111111130000
0000000000000000000000000000000000000000000000000000000000000000
0000000000000000000000000000000000000000000000000000000000000000
0000000000000000000000000000000000000000000000000000000000000000
